XXSXEXXXX\
XX X    X\
X  XXX XX\
X XX X XX\
X       X\
XXXXXXXXX\