XXXXXXXXX\
X       E\
X XXXX XX\
X     X X\
XX X XX X\
S X   X X\
X   X   X\
XXXXXXXXX\