XXXXXXXX\
XXXXX  S\
XXX   XX\
X   XXXX\
X XX   X\
X    X X\
XXXXXXEX\